[
  [
    "SLW_CORNER",
    "SLW_COLUMN",
    "FLOOR",
    "FLOOR",
    "LW_LPIT",
    "WATER",
    "WATER",
    "WATER",
    "V_WALKWAY",
    "WATER",
    "WATER",
    "WATER",
    "RW_RPIT",
    "FLOOR",
    "FLOOR",
    "SRW_COLUMN",
    "SRW_CORNER"
  ],
  [
    "EMPTY",
    "SLW_CORNER",
    "S_WALL",
    "S_WALL",
    "S_WALL",
    "SLW_WATER_COLUMN",
    "WATER",
    "WATER",
    "S_STAIR",
    "WATER",
    "WATER",
    "SRW_WATER_COLUMN",
    "S_WALL",
    "S_WALL",
    "S_WALL",
    "SRW_CORNER",
    "EMPTY"
  ],
  [
    "EMPTY",
    "EMPTY",
    "EMPTY",
    "EMPTY",
    "EMPTY",
    "L_WALL",
    "SW_SPIT",
    "SW_SPIT",
    "S_STAIRWALL",
    "SW_SPIT",
    "SW_SPIT",
    "R_WALL",
    "EMPTY",
    "EMPTY",
    "EMPTY",
    "EMPTY",
    "EMPTY"
  ],
  [
    "EMPTY",
    "EMPTY",
    "EMPTY",
    "EMPTY",
    "EMPTY",
    "L_WALL",
    "FLOOR",
    "FLOOR",
    "FLOOR",
    "FLOOR",
    "FLOOR",
    "R_WALL",
    "EMPTY",
    "EMPTY",
    "EMPTY",
    "EMPTY",
    "EMPTY"
  ],
  [
    "EMPTY",
    "EMPTY",
    "EMPTY",
    "EMPTY",
    "EMPTY",
    "L_WALL",
    "FLOOR",
    "FLOOR",
    "FLOOR",
    "FLOOR",
    "FLOOR",
    "R_WALL",
    "EMPTY",
    "EMPTY",
    "EMPTY",
    "EMPTY",
    "EMPTY"
  ],
  [
    "EMPTY",
    "EMPTY",
    "EMPTY",
    "EMPTY",
    "EMPTY",
    "SLW_CORNER",
    "SLW_COLUMN",
    "FLOOR",
    "FLOOR",
    "FLOOR",
    "SRW_COLUMN",
    "SRW_CORNER",
    "EMPTY",
    "EMPTY",
    "EMPTY",
    "EMPTY",
    "EMPTY"
  ],
  [
    "EMPTY",
    "EMPTY",
    "EMPTY",
    "EMPTY",
    "EMPTY",
    "EMPTY",
    "SLW_CORNER",
    "S_WALL",
    "S_WALL",
    "S_WALL",
    "SRW_CORNER",
    "EMPTY",
    "EMPTY",
    "EMPTY",
    "EMPTY",
    "EMPTY",
    "EMPTY"
  ],
  [
    "EMPTY",
    "EMPTY",
    "EMPTY",
    "EMPTY",
    "EMPTY",
    "EMPTY",
    "EMPTY",
    "EMPTY",
    "EMPTY",
    "EMPTY",
    "EMPTY",
    "EMPTY",
    "EMPTY",
    "EMPTY",
    "EMPTY",
    "EMPTY",
    "EMPTY"
  ],
  [
    "EMPTY",
    "EMPTY",
    "EMPTY",
    "EMPTY",
    "EMPTY",
    "EMPTY",
    "EMPTY",
    "EMPTY",
    "EMPTY",
    "EMPTY",
    "EMPTY",
    "EMPTY",
    "EMPTY",
    "EMPTY",
    "EMPTY",
    "EMPTY",
    "EMPTY"
  ]
]
